-----------------e-
-xxxxxxxxxxxxx-----
------x--x---x-----
--x-s-x--xx-xx-----
--x----------xxx-x-
----xxx---xxxx-----
-xx---x------------
------xxxxxx--xxx--
------x------------